10000000110000000000000
10000000110000000000000
10100000110000000000000
10000100110000000000000
10000000000000000000000
11111111110000000000000
10000000000000000000000
11111111111111111111111